#############
#S..#.......#
#.#.#.#####.#
#.#...#...#.#
#.#####.#.#.#
#.....#.#...#
###.#.#.###.#
#...#.#.....#
#.#.#.#####.#
#.#...#...#.#
#.#####.#.#G#
#...........#
#############